10 10
..*....*.*
*..*..***.
**..***...
.....*..*.
.*.*.*.*..
.***...*.*
.******..*
*.......**
*..*******
*.........